0,0,0,0,0,0,0,0,0,0,0,0,0,0,0,0,0,0,0,0,0,0,0,0,0,0,0,0,0,0,0,0,0,0,0,0,0,0,0,0,0,0,0,0,0,0,0,0,0,0,0,0,0,0,0,0,0,0,0,0,0,0,0,0,
0,0,0,0,0,0,0,0,0,0,0,0,0,0,0,0,0,0,0,0,0,0,0,0,0,0,0,0,0,0,0,0,0,0,0,0,0,0,0,0,0,0,0,0,0,0,0,0,0,0,0,0,0,0,0,0,0,0,0,0,0,0,0,0,
0,0,0,0,0,0,0,0,0,0,0,0,0,0,0,0,0,0,0,0,0,0,0,0,0,0,0,0,0,0,0,0,0,0,0,0,0,0,0,0,0,0,0,0,0,0,0,0,0,0,0,0,0,0,0,0,0,0,0,0,0,0,0,0,
0,0,0,0,0,0,0,0,0,0,0,0,0,0,0,0,0,0,0,0,0,0,0,0,0,0,0,0,0,0,0,0,0,0,0,0,0,0,0,0,0,0,0,0,0,0,0,0,0,0,105,1,1,1,105,0,0,0,0,0,0,0,0,0,
0,0,0,196,196,0,0,0,0,0,0,0,0,0,0,0,0,0,0,0,0,0,0,0,0,0,0,0,0,0,0,0,0,0,0,0,0,0,0,0,0,0,0,0,0,0,0,0,0,0,144,2,2,105,144,105,105,0,0,0,0,0,0,0,
0,0,209,209,209,209,0,0,0,0,0,0,0,0,0,0,0,0,0,0,0,0,0,0,0,0,0,0,0,0,0,0,0,0,0,0,0,0,0,0,0,0,0,0,0,0,0,105,0,105,144,105,105,144,144,144,144,105,105,105,0,0,0,0,
0,160,209,209,209,209,209,158,157,158,196,196,0,0,0,0,0,0,0,0,0,0,0,0,0,0,0,0,0,0,0,0,0,0,0,0,0,0,0,0,0,0,0,0,0,0,105,144,105,144,144,144,131,144,144,131,144,144,144,144,105,105,0,0,
160,159,157,157,160,157,160,157,159,157,160,160,0,0,0,0,0,0,0,0,0,0,0,0,0,0,0,0,0,0,0,0,0,0,0,0,0,0,0,0,0,0,0,105,105,105,144,144,144,131,131,131,131,131,131,131,131,144,144,144,144,144,105,105,
0,159,157,160,157,160,158,157,183,183,183,183,183,0,0,0,0,0,0,0,0,0,0,0,0,0,0,0,0,0,0,0,0,0,0,0,0,0,0,0,0,0,105,144,144,144,144,131,131,131,131,131,131,131,131,131,118,131,131,131,144,144,144,144,
0,0,157,159,158,157,183,183,183,0,0,0,0,0,0,0,0,0,0,0,0,0,0,0,0,0,0,0,0,0,0,0,0,0,0,0,0,0,0,0,0,105,144,131,118,131,131,131,118,131,118,131,131,118,131,118,118,118,131,131,131,131,131,131,
0,0,159,157,160,183,183,0,0,0,0,0,0,0,0,0,0,0,0,0,0,0,0,0,0,0,0,0,0,0,0,0,0,0,0,0,0,0,0,0,0,144,131,118,118,118,131,118,118,118,118,118,118,118,118,118,118,118,131,118,118,131,118,118,
0,0,0,0,0,0,0,0,0,0,0,0,0,0,0,0,0,0,0,0,0,0,0,0,0,0,0,0,0,0,0,0,0,0,0,0,0,0,0,0,0,0,118,118,118,118,118,118,118,118,118,118,118,118,118,118,118,118,118,118,118,118,118,118,
0,0,0,0,0,0,0,0,0,0,0,0,0,0,0,0,0,0,0,0,0,0,0,0,0,0,0,0,0,0,0,0,0,0,0,0,0,0,0,0,0,0,0,0,0,0,118,0,118,118,118,118,118,118,118,118,118,118,118,118,118,118,118,118,
0,0,0,0,0,0,0,0,0,0,0,0,0,0,0,0,0,0,0,0,0,0,0,0,0,0,0,0,0,0,0,0,0,0,0,0,0,0,0,0,0,0,0,0,0,0,0,0,0,0,0,0,118,118,118,118,118,118,118,118,118,118,118,118,
0,0,0,0,0,0,0,0,0,0,0,228,229,229,229,229,229,229,229,230,0,0,0,0,0,0,0,0,0,0,0,0,0,0,0,0,0,0,0,0,0,0,0,0,0,0,0,0,0,0,0,0,0,0,118,118,118,118,0,0,0,0,0,0,
0,0,0,0,0,0,0,0,0,0,0,225,226,226,226,226,226,226,226,227,0,0,0,0,0,0,0,0,0,0,0,0,0,0,0,0,0,0,0,0,0,0,0,0,0,0,0,0,0,0,0,0,0,0,0,0,118,0,0,0,0,0,0,0,
0,0,0,0,0,0,0,0,0,0,0,225,226,226,226,226,226,226,226,227,0,0,0,0,0,0,0,0,0,0,0,0,0,0,0,0,0,0,0,0,0,0,0,0,0,0,0,0,0,0,0,0,0,0,0,0,0,0,0,0,0,0,0,0,
0,0,0,0,0,0,0,0,0,0,0,225,226,226,226,226,226,226,226,227,0,0,0,0,0,0,0,0,0,0,0,0,0,0,0,0,0,0,0,0,0,0,0,0,0,0,0,0,0,0,0,0,0,0,0,0,0,0,0,0,0,0,0,0,
0,0,0,0,0,0,0,0,0,0,0,225,226,226,226,226,226,226,226,227,0,0,105,0,0,0,0,0,0,0,0,0,0,0,0,0,0,0,0,0,0,0,0,0,0,0,0,0,0,0,0,0,0,0,0,0,0,0,0,0,0,0,0,0,
0,0,0,0,0,0,0,0,0,0,0,222,223,223,223,223,223,223,223,224,0,0,144,105,0,0,0,0,0,0,0,0,0,0,0,0,0,0,0,0,0,0,0,0,0,0,0,0,0,0,0,0,0,0,0,0,0,0,0,0,0,0,0,0,
0,0,0,0,0,0,0,0,0,0,0,0,0,0,246,245,244,247,0,0,0,105,144,144,0,0,0,0,0,0,0,0,0,0,0,0,0,0,0,0,0,0,0,0,0,0,0,0,0,0,0,0,0,0,0,0,0,0,0,0,0,0,0,0,
0,0,0,0,105,0,0,0,0,0,0,0,0,0,0,0,243,0,0,0,92,144,144,144,105,0,0,0,0,0,0,0,0,0,0,0,0,0,0,0,0,0,0,0,0,0,0,0,0,0,0,0,0,0,0,0,0,0,0,0,0,0,0,0,
0,105,0,105,144,105,105,0,0,0,0,0,239,240,241,241,242,0,0,0,66,144,144,144,144,0,0,0,105,0,0,0,0,0,0,0,0,0,0,0,0,0,0,0,0,0,0,0,0,0,0,0,0,0,0,0,0,0,0,0,0,0,0,0,
105,144,105,144,144,144,144,105,105,0,0,235,236,237,238,0,0,0,0,0,0,27,144,144,144,105,0,0,144,105,0,0,0,0,0,0,0,0,0,0,0,0,0,0,0,0,0,0,0,0,0,0,0,0,0,209,196,183,105,105,105,105,105,0,
144,144,144,144,144,144,144,144,144,105,105,105,105,105,105,105,105,105,105,105,105,144,144,144,144,144,0,105,144,144,0,105,105,0,0,0,105,0,0,0,0,0,0,0,0,0,0,0,0,0,0,0,0,0,209,209,196,105,144,144,144,144,144,105,
144,144,144,144,144,144,144,144,144,144,144,144,144,144,144,144,144,144,144,144,144,144,144,144,144,144,105,144,144,144,1,144,144,105,105,105,144,0,0,0,0,0,0,0,0,0,0,0,0,0,0,0,0,0,209,209,105,144,144,144,144,144,144,144,
118,118,144,144,144,144,144,144,144,144,144,144,144,144,144,144,144,144,144,144,144,144,144,144,144,144,144,144,144,144,2,144,144,144,144,144,144,105,105,105,105,0,0,0,0,0,0,0,0,0,0,0,0,105,105,105,144,144,144,144,144,144,144,144,
118,118,131,131,131,131,131,131,131,131,144,144,144,144,144,131,144,131,131,131,131,131,144,144,144,144,144,131,144,144,144,144,131,131,144,144,144,144,144,144,144,105,0,0,0,0,0,0,0,0,0,0,105,144,144,144,144,144,144,144,144,144,144,144,
118,131,131,131,131,131,131,131,131,131,131,131,131,131,131,131,131,131,131,131,131,131,131,131,131,131,131,131,131,131,144,144,131,131,131,144,144,144,144,144,144,144,0,0,0,0,0,0,0,0,0,0,144,144,131,144,144,131,131,131,131,131,131,131,
118,118,131,131,118,131,131,131,131,131,131,131,118,131,131,131,131,131,131,131,131,131,131,131,131,131,131,131,131,131,131,131,131,131,131,131,131,131,131,131,131,144,0,0,0,0,0,0,0,0,92,105,144,131,131,131,131,131,131,131,131,131,131,118,
118,118,118,118,118,118,131,118,131,131,131,118,118,118,131,131,131,131,131,131,131,131,118,118,131,131,118,131,131,118,131,131,118,118,131,131,131,131,118,118,131,131,105,0,0,0,0,0,0,92,144,131,131,131,131,131,131,131,131,118,131,131,118,118,
118,118,118,118,118,118,118,118,118,118,118,118,118,118,118,118,118,118,118,118,131,131,118,118,118,118,118,118,118,118,118,118,118,118,118,131,118,118,118,118,118,131,131,105,0,0,0,0,92,144,131,131,131,131,131,131,131,118,118,118,118,118,118,118,
118,118,118,118,118,118,118,118,118,118,118,118,118,118,118,118,118,118,118,118,118,118,118,118,118,118,118,118,118,118,118,118,118,118,118,131,118,118,118,118,118,118,131,131,1,1,1,1,66,40,131,131,118,131,131,131,118,118,118,118,118,118,118,118,
118,118,118,118,118,118,118,118,118,118,118,118,118,118,118,118,118,118,118,118,118,118,118,118,118,118,118,118,118,118,118,118,118,118,118,118,118,118,118,118,118,118,131,131,2,2,2,2,2,2,118,118,118,118,118,118,118,118,118,118,118,118,118,118,
118,118,118,118,118,118,118,118,118,118,118,118,118,118,118,118,118,118,118,118,118,118,118,118,118,118,118,118,118,118,118,118,118,118,118,118,118,118,118,118,118,118,118,131,105,2,2,2,2,2,118,118,118,118,118,118,118,118,118,118,118,118,118,118,
118,118,118,118,118,118,118,118,118,118,118,118,118,118,118,118,118,118,118,118,118,118,118,118,118,118,118,118,118,118,118,118,118,118,118,118,118,118,118,118,118,118,118,118,118,172,171,170,173,170,118,118,118,118,118,118,118,118,118,118,118,118,118,118

